%%%%%%%%%%%%%%%%%%%%%%%%%%%%%%%
%              .              %
%                             %
%                             %
%                             %
%                             %
%                             %
%                             %
%                             %
%              P              %
%                             %
%                             %
%                             %
%                             %
%                             %
%.       P     .     P       .%
%                             %
%                             %
%                             %
%                             %
%                             %
%              P              %
%                             %
%                             %
%                             %
%                             %
%                             %
%                             %
%                             %
%              .              %
%%%%%%%%%%%%%%%%%%%%%%%%%%%%%%%
