%%%%%%%%%%%
%        P%
% %%%%%   %
% %%%%  % %
% %%%  %% %
% %%  %%% %
% %  %%%% %
%   %%%%% %
%.        %
%%%%%%%%%%%